/projects/piml_inversion/hwang/Illinois/src_chicoma/data/notch_filter_data/syn_data_fk_filtered_all_mlr_500_0_avg_mask_normal.npy	/projects/piml_inversion/hwang/Illinois/src_chicoma/data/heat_maps/syn_label_heat_map_random_intz_500_0.npy
/projects/piml_inversion/hwang/Illinois/src_chicoma/data/notch_filter_data/syn_data_fk_filtered_all_mlr_500_1_avg_mask_normal.npy	/projects/piml_inversion/hwang/Illinois/src_chicoma/data/heat_maps/syn_label_heat_map_random_intz_500_1.npy
/projects/piml_inversion/hwang/Illinois/src_chicoma/data/notch_filter_data/syn_data_fk_filtered_all_mlr_500_2_avg_mask_normal.npy	/projects/piml_inversion/hwang/Illinois/src_chicoma/data/heat_maps/syn_label_heat_map_random_intz_500_2.npy
/projects/piml_inversion/hwang/Illinois/src_chicoma/data/notch_filter_data/syn_data_fk_filtered_all_mlr_500_3_avg_mask_normal.npy	/projects/piml_inversion/hwang/Illinois/src_chicoma/data/heat_maps/syn_label_heat_map_random_intz_500_3.npy
/projects/piml_inversion/hwang/Illinois/src_chicoma/data/notch_filter_data/syn_data_fk_filtered_all_mlr_500_4_avg_mask_normal.npy	/projects/piml_inversion/hwang/Illinois/src_chicoma/data/heat_maps/syn_label_heat_map_random_intz_500_4.npy
/projects/piml_inversion/hwang/Illinois/src_chicoma/data/notch_filter_data/syn_data_fk_filtered_all_mlr_500_5_avg_mask_normal.npy	/projects/piml_inversion/hwang/Illinois/src_chicoma/data/heat_maps/syn_label_heat_map_random_intz_500_5.npy
/projects/piml_inversion/hwang/Illinois/src_chicoma/data/notch_filter_data/syn_data_fk_filtered_all_mlr_500_6_avg_mask_normal.npy	/projects/piml_inversion/hwang/Illinois/src_chicoma/data/heat_maps/syn_label_heat_map_random_intz_500_6.npy
/projects/piml_inversion/hwang/Illinois/src_chicoma/data/notch_filter_data/syn_data_fk_filtered_all_mlr_500_7_avg_mask_normal.npy	/projects/piml_inversion/hwang/Illinois/src_chicoma/data/heat_maps/syn_label_heat_map_random_intz_500_7.npy
/projects/piml_inversion/hwang/Illinois/src_chicoma/data/notch_filter_data/syn_data_fk_filtered_all_mlr_500_8_avg_mask_normal.npy	/projects/piml_inversion/hwang/Illinois/src_chicoma/data/heat_maps/syn_label_heat_map_random_intz_500_8.npy
/projects/piml_inversion/hwang/Illinois/src_chicoma/data/notch_filter_data/syn_data_fk_filtered_all_mlr_500_9_avg_mask_normal.npy	/projects/piml_inversion/hwang/Illinois/src_chicoma/data/heat_maps/syn_label_heat_map_random_intz_500_9.npy
/projects/piml_inversion/hwang/Illinois/src_chicoma/data/notch_filter_data/syn_data_fk_filtered_all_mlr_500_10_avg_mask_normal.npy	/projects/piml_inversion/hwang/Illinois/src_chicoma/data/heat_maps/syn_label_heat_map_random_intz_500_10.npy
/projects/piml_inversion/hwang/Illinois/src_chicoma/data/notch_filter_data/syn_data_fk_filtered_all_mlr_500_11_avg_mask_normal.npy	/projects/piml_inversion/hwang/Illinois/src_chicoma/data/heat_maps/syn_label_heat_map_random_intz_500_11.npy
/projects/piml_inversion/hwang/Illinois/src_chicoma/data/notch_filter_data/syn_data_fk_filtered_all_mlr_500_12_avg_mask_normal.npy	/projects/piml_inversion/hwang/Illinois/src_chicoma/data/heat_maps/syn_label_heat_map_random_intz_500_12.npy
/projects/piml_inversion/hwang/Illinois/src_chicoma/data/notch_filter_data/syn_data_fk_filtered_all_mlr_500_13_avg_mask_normal.npy	/projects/piml_inversion/hwang/Illinois/src_chicoma/data/heat_maps/syn_label_heat_map_random_intz_500_13.npy
/projects/piml_inversion/hwang/Illinois/src_chicoma/data/notch_filter_data/syn_data_fk_filtered_all_mlr_500_14_avg_mask_normal.npy	/projects/piml_inversion/hwang/Illinois/src_chicoma/data/heat_maps/syn_label_heat_map_random_intz_500_14.npy
/projects/piml_inversion/hwang/Illinois/src_chicoma/data/notch_filter_data/syn_data_fk_filtered_all_mlr_500_15_avg_mask_normal.npy	/projects/piml_inversion/hwang/Illinois/src_chicoma/data/heat_maps/syn_label_heat_map_random_intz_500_15.npy
/projects/piml_inversion/hwang/Illinois/src_chicoma/data/notch_filter_data/syn_data_fk_filtered_all_mlr_500_16_avg_mask_normal.npy	/projects/piml_inversion/hwang/Illinois/src_chicoma/data/heat_maps/syn_label_heat_map_random_intz_500_16.npy
/projects/piml_inversion/hwang/Illinois/src_chicoma/data/notch_filter_data/syn_data_fk_filtered_all_mlr_500_17_avg_mask_normal.npy	/projects/piml_inversion/hwang/Illinois/src_chicoma/data/heat_maps/syn_label_heat_map_random_intz_500_17.npy
/projects/piml_inversion/hwang/Illinois/src_chicoma/data/notch_filter_data/syn_data_fk_filtered_all_mlr_500_18_avg_mask_normal.npy	/projects/piml_inversion/hwang/Illinois/src_chicoma/data/heat_maps/syn_label_heat_map_random_intz_500_18.npy
/projects/piml_inversion/hwang/Illinois/src_chicoma/data/notch_filter_data/syn_data_fk_filtered_all_mlr_500_19_avg_mask_normal.npy	/projects/piml_inversion/hwang/Illinois/src_chicoma/data/heat_maps/syn_label_heat_map_random_intz_500_19.npy
/projects/piml_inversion/hwang/Illinois/src_chicoma/data/notch_filter_data/syn_data_fk_filtered_all_mlr_500_20_avg_mask_normal.npy	/projects/piml_inversion/hwang/Illinois/src_chicoma/data/heat_maps/syn_label_heat_map_random_intz_500_20.npy
/projects/piml_inversion/hwang/Illinois/src_chicoma/data/notch_filter_data/syn_data_fk_filtered_all_mlr_500_21_avg_mask_normal.npy	/projects/piml_inversion/hwang/Illinois/src_chicoma/data/heat_maps/syn_label_heat_map_random_intz_500_21.npy
/projects/piml_inversion/hwang/Illinois/src_chicoma/data/notch_filter_data/syn_data_fk_filtered_all_mlr_500_22_avg_mask_normal.npy	/projects/piml_inversion/hwang/Illinois/src_chicoma/data/heat_maps/syn_label_heat_map_random_intz_500_22.npy
/projects/piml_inversion/hwang/Illinois/src_chicoma/data/notch_filter_data/syn_data_fk_filtered_all_mlr_500_23_avg_mask_normal.npy	/projects/piml_inversion/hwang/Illinois/src_chicoma/data/heat_maps/syn_label_heat_map_random_intz_500_23.npy
/projects/piml_inversion/hwang/Illinois/src_chicoma/data/notch_filter_data/syn_data_fk_filtered_all_mlr_500_24_avg_mask_normal.npy	/projects/piml_inversion/hwang/Illinois/src_chicoma/data/heat_maps/syn_label_heat_map_random_intz_500_24.npy
/projects/piml_inversion/hwang/Illinois/src_chicoma/data/notch_filter_data/syn_data_fk_filtered_all_mlr_500_25_avg_mask_normal.npy	/projects/piml_inversion/hwang/Illinois/src_chicoma/data/heat_maps/syn_label_heat_map_random_intz_500_25.npy
/projects/piml_inversion/hwang/Illinois/src_chicoma/data/notch_filter_data/syn_data_fk_filtered_all_mlr_500_26_avg_mask_normal.npy	/projects/piml_inversion/hwang/Illinois/src_chicoma/data/heat_maps/syn_label_heat_map_random_intz_500_26.npy
/projects/piml_inversion/hwang/Illinois/src_chicoma/data/notch_filter_data/syn_data_fk_filtered_all_mlr_500_27_avg_mask_normal.npy	/projects/piml_inversion/hwang/Illinois/src_chicoma/data/heat_maps/syn_label_heat_map_random_intz_500_27.npy
/projects/piml_inversion/hwang/Illinois/src_chicoma/data/notch_filter_data/syn_data_fk_filtered_all_mlr_500_28_avg_mask_normal.npy	/projects/piml_inversion/hwang/Illinois/src_chicoma/data/heat_maps/syn_label_heat_map_random_intz_500_28.npy
/projects/piml_inversion/hwang/Illinois/src_chicoma/data/notch_filter_data/syn_data_fk_filtered_all_mlr_500_29_avg_mask_normal.npy	/projects/piml_inversion/hwang/Illinois/src_chicoma/data/heat_maps/syn_label_heat_map_random_intz_500_29.npy
/projects/piml_inversion/hwang/Illinois/src_chicoma/data/notch_filter_data/syn_data_fk_filtered_all_mlr_500_30_avg_mask_normal.npy	/projects/piml_inversion/hwang/Illinois/src_chicoma/data/heat_maps/syn_label_heat_map_random_intz_500_30.npy
/projects/piml_inversion/hwang/Illinois/src_chicoma/data/notch_filter_data/syn_data_fk_filtered_all_mlr_500_31_avg_mask_normal.npy	/projects/piml_inversion/hwang/Illinois/src_chicoma/data/heat_maps/syn_label_heat_map_random_intz_500_31.npy
